country;geoid;pop;schedule;daily_cases;daily_deaths;cumulative_cases;cumulative_deaths;t
Brazil;BR;211049519;2020-02-26;1;0;1;0;1
Brazil;BR;211049519;2020-02-27;0;0;1;0;2
Brazil;BR;211049519;2020-02-28;0;0;1;0;3
Brazil;BR;211049519;2020-02-29;0;0;1;0;4
Brazil;BR;211049519;2020-03-01;1;0;2;0;5
Brazil;BR;211049519;2020-03-02;0;0;2;0;6
Brazil;BR;211049519;2020-03-03;0;0;2;0;7
Brazil;BR;211049519;2020-03-04;0;0;2;0;8
Brazil;BR;211049519;2020-03-05;1;0;3;0;9
Brazil;BR;211049519;2020-03-06;5;0;8;0;10
Brazil;BR;211049519;2020-03-07;5;0;13;0;11
Brazil;BR;211049519;2020-03-08;0;0;13;0;12
Brazil;BR;211049519;2020-03-09;12;0;25;0;13
Brazil;BR;211049519;2020-03-10;0;0;25;0;14
Brazil;BR;211049519;2020-03-11;9;0;34;0;15
Brazil;BR;211049519;2020-03-12;18;0;52;0;16
Brazil;BR;211049519;2020-03-13;25;0;77;0;17
Brazil;BR;211049519;2020-03-14;21;0;98;0;18
Brazil;BR;211049519;2020-03-15;23;0;121;0;19
Brazil;BR;211049519;2020-03-16;79;0;200;0;20
Brazil;BR;211049519;2020-03-17;34;0;234;0;21
Brazil;BR;211049519;2020-03-18;57;1;291;1;22
Brazil;BR;211049519;2020-03-19;137;3;428;4;23
Brazil;BR;211049519;2020-03-20;193;2;621;6;24
Brazil;BR;211049519;2020-03-21;283;5;904;11;25
Brazil;BR;211049519;2020-03-22;224;7;1128;18;26
Brazil;BR;211049519;2020-03-23;418;7;1546;25;27
Brazil;BR;211049519;2020-03-24;345;9;1891;34;28
Brazil;BR;211049519;2020-03-25;310;12;2201;46;29
Brazil;BR;211049519;2020-03-26;232;11;2433;57;30
Brazil;BR;211049519;2020-03-27;482;20;2915;77;31
Brazil;BR;211049519;2020-03-28;502;15;3417;92;32
Brazil;BR;211049519;2020-03-29;487;22;3904;114;33
Brazil;BR;211049519;2020-03-30;352;22;4256;136;34
Brazil;BR;211049519;2020-03-31;323;23;4579;159;35
Brazil;BR;211049519;2020-04-01;1138;42;5717;201;36
Brazil;BR;211049519;2020-04-02;1119;40;6836;241;37
Brazil;BR;211049519;2020-04-03;1074;58;7910;299;38
Brazil;BR;211049519;2020-04-04;1146;60;9056;359;39
Brazil;BR;211049519;2020-04-05;1222;73;10278;432;40
Brazil;BR;211049519;2020-04-06;852;54;11130;486;41
Brazil;BR;211049519;2020-04-07;926;67;12056;553;42
Brazil;BR;211049519;2020-04-08;1661;114;13717;667;43
Brazil;BR;211049519;2020-04-09;2210;133;15927;800;44
Brazil;BR;211049519;2020-04-10;1930;141;17857;941;45
Brazil;BR;211049519;2020-04-11;1781;115;19638;1056;46
Brazil;BR;211049519;2020-04-12;1089;68;20727;1124;47
Brazil;BR;211049519;2020-04-13;1442;99;22169;1223;48
Brazil;BR;211049519;2020-04-14;1261;105;23430;1328;49
Brazil;BR;211049519;2020-04-15;1832;204;25262;1532;50
Brazil;BR;211049519;2020-04-16;3058;204;28320;1736;51
Brazil;BR;211049519;2020-04-17;2105;188;30425;1924;52
Brazil;BR;211049519;2020-04-18;3257;217;33682;2141;53
Brazil;BR;211049519;2020-04-19;2917;206;36599;2347;54
Brazil;BR;211049519;2020-04-20;2055;115;38654;2462;55
Brazil;BR;211049519;2020-04-21;1927;113;40581;2575;56
Brazil;BR;211049519;2020-04-22;2498;166;43079;2741;57
Brazil;BR;211049519;2020-04-23;2678;165;45757;2906;58
Brazil;BR;211049519;2020-04-24;3735;407;49492;3313;59
Brazil;BR;211049519;2020-04-25;3503;357;52995;3670;60
Brazil;BR;211049519;2020-04-26;5514;346;58509;4016;61
Brazil;BR;211049519;2020-04-27;3379;189;61888;4205;62
Brazil;BR;211049519;2020-04-28;4613;338;66501;4543;63
Brazil;BR;211049519;2020-04-29;5385;474;71886;5017;64
Brazil;BR;211049519;2020-04-30;6276;449;78162;5466;65
Brazil;BR;211049519;2020-05-01;7218;435;85380;5901;66
Brazil;BR;211049519;2020-05-02;6209;428;91589;6329;67
Brazil;BR;211049519;2020-05-03;4970;421;96559;6750;68
Brazil;BR;211049519;2020-05-04;4588;275;101147;7025;69
Brazil;BR;211049519;2020-05-05;6633;296;107780;7321;70
Brazil;BR;211049519;2020-05-06;6935;600;114715;7921;71
Brazil;BR;211049519;2020-05-07;10503;615;125218;8536;72
Brazil;BR;211049519;2020-05-08;9888;610;135106;9146;73
Brazil;BR;211049519;2020-05-09;10222;751;145328;9897;74
Brazil;BR;211049519;2020-05-10;10611;730;155939;10627;75
Brazil;BR;211049519;2020-05-11;6760;496;162699;11123;76
Brazil;BR;211049519;2020-05-12;5632;396;168331;11519;77
Brazil;BR;211049519;2020-05-13;9258;881;177589;12400;78
Brazil;BR;211049519;2020-05-14;11385;749;188974;13149;79
Brazil;BR;211049519;2020-05-15;13944;844;202918;13993;80
Brazil;BR;211049519;2020-05-16;15305;824;218223;14817;81
Brazil;BR;211049519;2020-05-17;14919;816;233142;15633;82
Brazil;BR;211049519;2020-05-18;7938;485;241080;16118;83
Brazil;BR;211049519;2020-05-19;13140;674;254220;16792;84
Brazil;BR;211049519;2020-05-20;17408;1179;271628;17971;85
Brazil;BR;211049519;2020-05-21;19951;888;291579;18859;86
Brazil;BR;211049519;2020-05-22;18508;1188;310087;20047;87
Brazil;BR;211049519;2020-05-23;20803;1001;330890;21048;88
Brazil;BR;211049519;2020-05-24;16508;965;347398;22013;89
Brazil;BR;211049519;2020-05-25;15813;653;363211;22666;90
Brazil;BR;211049519;2020-05-26;11687;807;374898;23473;91
Brazil;BR;211049519;2020-05-27;16324;1039;391222;24512;92
Brazil;BR;211049519;2020-05-28;20599;1086;411821;25598;93
Brazil;BR;211049519;2020-05-29;26417;1156;438238;26754;94
Brazil;BR;211049519;2020-05-30;26928;1124;465166;27878;95
Brazil;BR;211049519;2020-05-31;33274;956;498440;28834;96
Brazil;BR;211049519;2020-06-01;16409;480;514849;29314;97
Brazil;BR;211049519;2020-06-02;11598;623;526447;29937;98
Brazil;BR;211049519;2020-06-03;28936;1262;555383;31199;99
Brazil;BR;211049519;2020-06-04;28633;1349;584016;32548;100
Brazil;BR;211049519;2020-06-05;30916;1473;614932;34021;101
Brazil;BR;211049519;2020-06-06;30830;1005;645762;35026;102
Brazil;BR;211049519;2020-06-07;27075;904;672837;35930;103
Brazil;BR;211049519;2020-06-08;18921;525;691758;36455;104
Brazil;BR;211049519;2020-06-09;15654;679;707412;37134;105
Brazil;BR;211049519;2020-06-10;32091;1272;739503;38406;106
Brazil;BR;211049519;2020-06-11;32913;1274;772416;39680;107
Brazil;BR;211049519;2020-06-12;30412;1239;802828;40919;108
Brazil;BR;211049519;2020-06-13;25982;909;828810;41828;109
Brazil;BR;211049519;2020-06-14;21704;892;850514;42720;110
Brazil;BR;211049519;2020-06-15;17110;612;867624;43332;111
Brazil;BR;211049519;2020-06-16;20647;627;888271;43959;112
Brazil;BR;211049519;2020-06-17;34918;1282;923189;45241;113
Brazil;BR;211049519;2020-06-18;32188;1269;955377;46510;114
Brazil;BR;211049519;2020-06-19;22765;1238;978142;47748;115
Brazil;BR;211049519;2020-06-20;54771;1206;1032913;48954;116
Brazil;BR;211049519;2020-06-21;34666;1022;1067579;49976;117
Brazil;BR;211049519;2020-06-22;17459;641;1085038;50617;118
Brazil;BR;211049519;2020-06-23;21432;654;1106470;51271;119
Brazil;BR;211049519;2020-06-24;39436;1374;1145906;52645;120
Brazil;BR;211049519;2020-06-25;42725;1185;1188631;53830;121
Brazil;BR;211049519;2020-06-26;39483;1141;1228114;54971;122
Brazil;BR;211049519;2020-06-27;46860;990;1274974;55961;123
Brazil;BR;211049519;2020-06-28;38693;1109;1313667;57070;124
Brazil;BR;211049519;2020-06-29;30476;552;1344143;57622;125
Brazil;BR;211049519;2020-06-30;24052;692;1368195;58314;126
Brazil;BR;211049519;2020-07-01;33846;1280;1402041;59594;127
Brazil;BR;211049519;2020-07-02;46712;1038;1448753;60632;128
Brazil;BR;211049519;2020-07-03;48105;1252;1496858;61884;129
Brazil;BR;211049519;2020-07-04;42223;1290;1539081;63174;130
Brazil;BR;211049519;2020-07-05;37923;1091;1577004;64265;131
Brazil;BR;211049519;2020-07-06;26051;602;1603055;64867;132
Brazil;BR;211049519;2020-07-07;20229;620;1623284;65487;133
Brazil;BR;211049519;2020-07-08;45305;1254;1668589;66741;134
Brazil;BR;211049519;2020-07-09;44571;1223;1713160;67964;135
Brazil;BR;211049519;2020-07-10;42619;1220;1755779;69184;136
Brazil;BR;211049519;2020-07-11;45048;1214;1800827;70398;137
Brazil;BR;211049519;2020-07-12;39023;1071;1839850;71469;138
Brazil;BR;211049519;2020-07-13;24831;631;1864681;72100;139
Brazil;BR;211049519;2020-07-14;20286;733;1884967;72833;140
Brazil;BR;211049519;2020-07-15;41857;1300;1926824;74133;141
Brazil;BR;211049519;2020-07-16;39924;1233;1966748;75366;142
Brazil;BR;211049519;2020-07-17;45403;1322;2012151;76688;143
Brazil;BR;211049519;2020-07-18;34177;1163;2046328;77851;144
Brazil;BR;211049519;2020-07-19;28532;921;2074860;78772;145
Brazil;BR;211049519;2020-07-20;23529;716;2098389;79488;146
Brazil;BR;211049519;2020-07-21;20257;632;2118646;80120;147
Brazil;BR;211049519;2020-07-22;41008;1367;2159654;81487;148
Brazil;BR;211049519;2020-07-23;67860;1284;2227514;82771;149
Italy;IT;60359546;2020-01-31;3;0;3;0;1
Italy;IT;60359546;2020-02-01;0;0;3;0;2
Italy;IT;60359546;2020-02-02;0;0;3;0;3
Italy;IT;60359546;2020-02-03;0;0;3;0;4
Italy;IT;60359546;2020-02-04;0;0;3;0;5
Italy;IT;60359546;2020-02-05;0;0;3;0;6
Italy;IT;60359546;2020-02-06;0;0;3;0;7
Italy;IT;60359546;2020-02-07;0;0;3;0;8
Italy;IT;60359546;2020-02-08;0;0;3;0;9
Italy;IT;60359546;2020-02-09;0;0;3;0;10
Italy;IT;60359546;2020-02-10;0;0;3;0;11
Italy;IT;60359546;2020-02-11;0;0;3;0;12
Italy;IT;60359546;2020-02-12;0;0;3;0;13
Italy;IT;60359546;2020-02-13;0;0;3;0;14
Italy;IT;60359546;2020-02-14;0;0;3;0;15
Italy;IT;60359546;2020-02-15;0;0;3;0;16
Italy;IT;60359546;2020-02-16;0;0;3;0;17
Italy;IT;60359546;2020-02-17;0;0;3;0;18
Italy;IT;60359546;2020-02-18;0;0;3;0;19
Italy;IT;60359546;2020-02-19;0;0;3;0;20
Italy;IT;60359546;2020-02-20;0;0;3;0;21
Italy;IT;60359546;2020-02-21;0;0;3;0;22
Italy;IT;60359546;2020-02-22;14;0;17;0;23
Italy;IT;60359546;2020-02-23;62;2;79;2;24
Italy;IT;60359546;2020-02-24;53;0;132;2;25
Italy;IT;60359546;2020-02-25;97;4;229;6;26
Italy;IT;60359546;2020-02-26;93;5;322;11;27
Italy;IT;60359546;2020-02-27;78;1;400;12;28
Italy;IT;60359546;2020-02-28;250;5;650;17;29
Italy;IT;60359546;2020-02-29;238;4;888;21;30
Italy;IT;60359546;2020-03-01;240;8;1128;29;31
Italy;IT;60359546;2020-03-02;561;6;1689;35;32
Italy;IT;60359546;2020-03-03;347;17;2036;52;33
Italy;IT;60359546;2020-03-04;466;28;2502;80;34
Italy;IT;60359546;2020-03-05;587;27;3089;107;35
Italy;IT;60359546;2020-03-06;769;41;3858;148;36
Italy;IT;60359546;2020-03-07;778;49;4636;197;37
Italy;IT;60359546;2020-03-08;1247;36;5883;233;38
Italy;IT;60359546;2020-03-09;1492;133;7375;366;39
Italy;IT;60359546;2020-03-10;1797;98;9172;464;40
Italy;IT;60359546;2020-03-11;977;167;10149;631;41
Italy;IT;60359546;2020-03-12;2313;196;12462;827;42
Italy;IT;60359546;2020-03-13;2651;189;15113;1016;43
Italy;IT;60359546;2020-03-14;2547;252;17660;1268;44
Italy;IT;60359546;2020-03-15;3497;173;21157;1441;45
Italy;IT;60359546;2020-03-16;2823;370;23980;1811;46
Italy;IT;60359546;2020-03-17;4000;347;27980;2158;47
Italy;IT;60359546;2020-03-18;3526;347;31506;2505;48
Italy;IT;60359546;2020-03-19;4207;473;35713;2978;49
Italy;IT;60359546;2020-03-20;5322;429;41035;3407;50
Italy;IT;60359546;2020-03-21;5986;625;47021;4032;51
Italy;IT;60359546;2020-03-22;6557;795;53578;4827;52
Italy;IT;60359546;2020-03-23;5560;649;59138;5476;53
Italy;IT;60359546;2020-03-24;4789;601;63927;6077;54
Italy;IT;60359546;2020-03-25;5249;743;69176;6820;55
Italy;IT;60359546;2020-03-26;5210;685;74386;7505;56
Italy;IT;60359546;2020-03-27;6153;660;80539;8165;57
Italy;IT;60359546;2020-03-28;5959;971;86498;9136;58
Italy;IT;60359546;2020-03-29;5974;887;92472;10023;59
Italy;IT;60359546;2020-03-30;5217;758;97689;10781;60
Italy;IT;60359546;2020-03-31;4050;810;101739;11591;61
Italy;IT;60359546;2020-04-01;4053;839;105792;12430;62
Italy;IT;60359546;2020-04-02;4782;727;110574;13157;63
Italy;IT;60359546;2020-04-03;4668;760;115242;13917;64
Italy;IT;60359546;2020-04-04;4585;764;119827;14681;65
Italy;IT;60359546;2020-04-05;4805;681;124632;15362;66
Italy;IT;60359546;2020-04-06;4316;527;128948;15889;67
Italy;IT;60359546;2020-04-07;3599;636;132547;16525;68
Italy;IT;60359546;2020-04-08;3039;604;135586;17129;69
Italy;IT;60359546;2020-04-09;3836;540;139422;17669;70
Italy;IT;60359546;2020-04-10;4204;612;143626;18281;71
Italy;IT;60359546;2020-04-11;3951;570;147577;18851;72
Italy;IT;60359546;2020-04-12;4694;619;152271;19470;73
Italy;IT;60359546;2020-04-13;4092;431;156363;19901;74
Italy;IT;60359546;2020-04-14;3153;564;159516;20465;75
Italy;IT;60359546;2020-04-15;2972;604;162488;21069;76
Italy;IT;60359546;2020-04-16;2667;578;165155;21647;77
Italy;IT;60359546;2020-04-17;3786;525;168941;22172;78
Italy;IT;60359546;2020-04-18;3493;575;172434;22747;79
Italy;IT;60359546;2020-04-19;3491;480;175925;23227;80
Italy;IT;60359546;2020-04-20;3047;433;178972;23660;81
Italy;IT;60359546;2020-04-21;2256;454;181228;24114;82
Italy;IT;60359546;2020-04-22;2729;534;183957;24648;83
Italy;IT;60359546;2020-04-23;3370;437;187327;25085;84
Italy;IT;60359546;2020-04-24;2646;464;189973;25549;85
Italy;IT;60359546;2020-04-25;3021;420;192994;25969;86
Italy;IT;60359546;2020-04-26;2357;415;195351;26384;87
Italy;IT;60359546;2020-04-27;2324;260;197675;26644;88
Italy;IT;60359546;2020-04-28;1739;333;199414;26977;89
Italy;IT;60359546;2020-04-29;2091;382;201505;27359;90
Italy;IT;60359546;2020-04-30;2086;323;203591;27682;91
Italy;IT;60359546;2020-05-01;1872;285;205463;27967;92
Italy;IT;60359546;2020-05-02;1965;269;207428;28236;93
Italy;IT;60359546;2020-05-03;1900;474;209328;28710;94
Italy;IT;60359546;2020-05-04;1389;174;210717;28884;95
Italy;IT;60359546;2020-05-05;1221;195;211938;29079;96
Italy;IT;60359546;2020-05-06;1075;236;213013;29315;97
Italy;IT;60359546;2020-05-07;1444;369;214457;29684;98
Italy;IT;60359546;2020-05-08;1401;274;215858;29958;99
Italy;IT;60359546;2020-05-09;1327;243;217185;30201;100
Italy;IT;60359546;2020-05-10;1083;194;218268;30395;101
Italy;IT;60359546;2020-05-11;802;165;219070;30560;102
Italy;IT;60359546;2020-05-12;744;179;219814;30739;103
Italy;IT;60359546;2020-05-13;1402;172;221216;30911;104
Italy;IT;60359546;2020-05-14;888;195;222104;31106;105
Italy;IT;60359546;2020-05-15;992;262;223096;31368;106
Italy;IT;60359546;2020-05-16;789;242;223885;31610;107
Italy;IT;60359546;2020-05-17;875;153;224760;31763;108
Italy;IT;60359546;2020-05-18;675;145;225435;31908;109
Italy;IT;60359546;2020-05-19;451;99;225886;32007;110
Italy;IT;60359546;2020-05-20;813;162;226699;32169;111
Italy;IT;60359546;2020-05-21;665;161;227364;32330;112
Italy;IT;60359546;2020-05-22;642;156;228006;32486;113
Italy;IT;60359546;2020-05-23;652;130;228658;32616;114
Italy;IT;60359546;2020-05-24;669;119;229327;32735;115
Italy;IT;60359546;2020-05-25;531;50;229858;32785;116
Italy;IT;60359546;2020-05-26;300;92;230158;32877;117
Italy;IT;60359546;2020-05-27;397;78;230555;32955;118
Italy;IT;60359546;2020-05-28;584;117;231139;33072;119
Italy;IT;60359546;2020-05-29;593;70;231732;33142;120
Italy;IT;60359546;2020-05-30;516;87;232248;33229;121
Italy;IT;60359546;2020-05-31;416;111;232664;33340;122
Italy;IT;60359546;2020-06-01;355;75;233019;33415;123
Italy;IT;60359546;2020-06-02;178;60;233197;33475;124
Italy;IT;60359546;2020-06-03;318;55;233515;33530;125
Italy;IT;60359546;2020-06-04;321;71;233836;33601;126
Italy;IT;60359546;2020-06-05;177;88;234013;33689;127
Italy;IT;60359546;2020-06-06;518;85;234531;33774;128
Italy;IT;60359546;2020-06-07;270;72;234801;33846;129
Italy;IT;60359546;2020-06-08;197;53;234998;33899;130
Italy;IT;60359546;2020-06-09;280;65;235278;33964;131
Italy;IT;60359546;2020-06-10;283;79;235561;34043;132
Italy;IT;60359546;2020-06-11;202;71;235763;34114;133
Italy;IT;60359546;2020-06-12;379;53;236142;34167;134
Italy;IT;60359546;2020-06-13;163;56;236305;34223;135
Italy;IT;60359546;2020-06-14;346;78;236651;34301;136
Italy;IT;60359546;2020-06-15;338;44;236989;34345;137
Italy;IT;60359546;2020-06-16;301;26;237290;34371;138
Italy;IT;60359546;2020-06-17;210;34;237500;34405;139
Italy;IT;60359546;2020-06-18;328;43;237828;34448;140
Italy;IT;60359546;2020-06-19;331;66;238159;34514;141
Italy;IT;60359546;2020-06-20;-148;47;238011;34561;142
Italy;IT;60359546;2020-06-21;264;49;238275;34610;143
Italy;IT;60359546;2020-06-22;224;24;238499;34634;144
Italy;IT;60359546;2020-06-23;221;23;238720;34657;145
Italy;IT;60359546;2020-06-24;113;18;238833;34675;146
Italy;IT;60359546;2020-06-25;577;-31;239410;34644;147
Italy;IT;60359546;2020-06-26;296;34;239706;34678;148
Italy;IT;60359546;2020-06-27;255;30;239961;34708;149
Italy;IT;60359546;2020-06-28;175;8;240136;34716;150
Italy;IT;60359546;2020-06-29;174;22;240310;34738;151
Italy;IT;60359546;2020-06-30;126;6;240436;34744;152
Italy;IT;60359546;2020-07-01;142;23;240578;34767;153
Italy;IT;60359546;2020-07-02;182;21;240760;34788;154
Italy;IT;60359546;2020-07-03;201;30;240961;34818;155
Italy;IT;60359546;2020-07-04;223;15;241184;34833;156
Italy;IT;60359546;2020-07-05;235;21;241419;34854;157
Italy;IT;60359546;2020-07-06;192;7;241611;34861;158
Italy;IT;60359546;2020-07-07;208;8;241819;34869;159
Italy;IT;60359546;2020-07-08;137;30;241956;34899;160
Italy;IT;60359546;2020-07-09;193;15;242149;34914;161
Italy;IT;60359546;2020-07-10;214;12;242363;34926;162
Italy;IT;60359546;2020-07-11;276;12;242639;34938;163
Italy;IT;60359546;2020-07-12;188;7;242827;34945;164
Italy;IT;60359546;2020-07-13;234;9;243061;34954;165
Italy;IT;60359546;2020-07-14;169;13;243230;34967;166
Italy;IT;60359546;2020-07-15;114;17;243344;34984;167
Italy;IT;60359546;2020-07-16;162;13;243506;34997;168
Italy;IT;60359546;2020-07-17;230;20;243736;35017;169
Italy;IT;60359546;2020-07-18;231;11;243967;35028;170
Italy;IT;60359546;2020-07-19;249;14;244216;35042;171
Italy;IT;60359546;2020-07-20;218;3;244434;35045;172
Italy;IT;60359546;2020-07-21;190;13;244624;35058;173
Italy;IT;60359546;2020-07-22;128;15;244752;35073;174
Italy;IT;60359546;2020-07-23;280;9;245032;35082;175
United_Kingdom;UK;66647112;2020-01-31;2;0;2;0;1
United_Kingdom;UK;66647112;2020-02-01;0;0;2;0;2
United_Kingdom;UK;66647112;2020-02-02;0;0;2;0;3
United_Kingdom;UK;66647112;2020-02-03;0;0;2;0;4
United_Kingdom;UK;66647112;2020-02-04;0;0;2;0;5
United_Kingdom;UK;66647112;2020-02-05;0;0;2;0;6
United_Kingdom;UK;66647112;2020-02-06;0;0;2;0;7
United_Kingdom;UK;66647112;2020-02-07;1;0;3;0;8
United_Kingdom;UK;66647112;2020-02-08;0;0;3;0;9
United_Kingdom;UK;66647112;2020-02-09;1;0;4;0;10
United_Kingdom;UK;66647112;2020-02-10;0;0;4;0;11
United_Kingdom;UK;66647112;2020-02-11;4;0;8;0;12
United_Kingdom;UK;66647112;2020-02-12;0;0;8;0;13
United_Kingdom;UK;66647112;2020-02-13;1;0;9;0;14
United_Kingdom;UK;66647112;2020-02-14;0;0;9;0;15
United_Kingdom;UK;66647112;2020-02-15;0;0;9;0;16
United_Kingdom;UK;66647112;2020-02-16;0;0;9;0;17
United_Kingdom;UK;66647112;2020-02-17;0;0;9;0;18
United_Kingdom;UK;66647112;2020-02-18;0;0;9;0;19
United_Kingdom;UK;66647112;2020-02-19;0;0;9;0;20
United_Kingdom;UK;66647112;2020-02-20;0;0;9;0;21
United_Kingdom;UK;66647112;2020-02-21;0;0;9;0;22
United_Kingdom;UK;66647112;2020-02-22;0;0;9;0;23
United_Kingdom;UK;66647112;2020-02-23;0;0;9;0;24
United_Kingdom;UK;66647112;2020-02-24;4;0;13;0;25
United_Kingdom;UK;66647112;2020-02-25;0;0;13;0;26
United_Kingdom;UK;66647112;2020-02-26;0;0;13;0;27
United_Kingdom;UK;66647112;2020-02-27;0;0;13;0;28
United_Kingdom;UK;66647112;2020-02-28;3;0;16;0;29
United_Kingdom;UK;66647112;2020-02-29;2;0;18;0;30
United_Kingdom;UK;66647112;2020-03-01;5;0;23;0;31
United_Kingdom;UK;66647112;2020-03-02;13;0;36;0;32
United_Kingdom;UK;66647112;2020-03-03;4;0;40;0;33
United_Kingdom;UK;66647112;2020-03-04;11;0;51;0;34
United_Kingdom;UK;66647112;2020-03-05;34;0;85;0;35
United_Kingdom;UK;66647112;2020-03-06;30;0;115;0;36
United_Kingdom;UK;66647112;2020-03-07;48;1;163;1;37
United_Kingdom;UK;66647112;2020-03-08;43;1;206;2;38
United_Kingdom;UK;66647112;2020-03-09;67;0;273;2;39
United_Kingdom;UK;66647112;2020-03-10;48;1;321;3;40
United_Kingdom;UK;66647112;2020-03-11;52;4;373;7;41
United_Kingdom;UK;66647112;2020-03-12;83;0;456;7;42
United_Kingdom;UK;66647112;2020-03-13;134;2;590;9;43
United_Kingdom;UK;66647112;2020-03-14;117;1;707;10;44
United_Kingdom;UK;66647112;2020-03-15;433;18;1140;28;45
United_Kingdom;UK;66647112;2020-03-16;251;15;1391;43;46
United_Kingdom;UK;66647112;2020-03-17;152;22;1543;65;47
United_Kingdom;UK;66647112;2020-03-18;407;16;1950;81;48
United_Kingdom;UK;66647112;2020-03-19;680;34;2630;115;49
United_Kingdom;UK;66647112;2020-03-20;647;43;3277;158;50
United_Kingdom;UK;66647112;2020-03-21;706;36;3983;194;51
United_Kingdom;UK;66647112;2020-03-22;1035;56;5018;250;52
United_Kingdom;UK;66647112;2020-03-23;665;35;5683;285;53
United_Kingdom;UK;66647112;2020-03-24;967;74;6650;359;54
United_Kingdom;UK;66647112;2020-03-25;1427;149;8077;508;55
United_Kingdom;UK;66647112;2020-03-26;1452;186;9529;694;56
United_Kingdom;UK;66647112;2020-03-27;2129;183;11658;877;57
United_Kingdom;UK;66647112;2020-03-28;2885;284;14543;1161;58
United_Kingdom;UK;66647112;2020-03-29;2546;294;17089;1455;59
United_Kingdom;UK;66647112;2020-03-30;2433;214;19522;1669;60
United_Kingdom;UK;66647112;2020-03-31;2619;374;22141;2043;61
United_Kingdom;UK;66647112;2020-04-01;3009;382;25150;2425;62
United_Kingdom;UK;66647112;2020-04-02;4324;670;29474;3095;63
United_Kingdom;UK;66647112;2020-04-03;4244;652;33718;3747;64
United_Kingdom;UK;66647112;2020-04-04;4450;714;38168;4461;65
United_Kingdom;UK;66647112;2020-04-05;3735;760;41903;5221;66
United_Kingdom;UK;66647112;2020-04-06;5903;644;47806;5865;67
United_Kingdom;UK;66647112;2020-04-07;3802;568;51608;6433;68
United_Kingdom;UK;66647112;2020-04-08;3634;1038;55242;7471;69
United_Kingdom;UK;66647112;2020-04-09;5491;1034;60733;8505;70
United_Kingdom;UK;66647112;2020-04-10;4344;1103;65077;9608;71
United_Kingdom;UK;66647112;2020-04-11;5195;1152;70272;10760;72
United_Kingdom;UK;66647112;2020-04-12;8719;839;78991;11599;73
United_Kingdom;UK;66647112;2020-04-13;5288;686;84279;12285;74
United_Kingdom;UK;66647112;2020-04-14;4342;744;88621;13029;75
United_Kingdom;UK;66647112;2020-04-15;5252;1044;93873;14073;76
United_Kingdom;UK;66647112;2020-04-16;4603;842;98476;14915;77
United_Kingdom;UK;66647112;2020-04-17;4617;1029;103093;15944;78
United_Kingdom;UK;66647112;2020-04-18;5599;935;108692;16879;79
United_Kingdom;UK;66647112;2020-04-19;5525;1115;114217;17994;80
United_Kingdom;UK;66647112;2020-04-20;5850;498;120067;18492;81
United_Kingdom;UK;66647112;2020-04-21;4676;559;124743;19051;82
United_Kingdom;UK;66647112;2020-04-22;4301;1172;129044;20223;83
United_Kingdom;UK;66647112;2020-04-23;4451;837;133495;21060;84
United_Kingdom;UK;66647112;2020-04-24;4583;727;138078;21787;85
United_Kingdom;UK;66647112;2020-04-25;5386;1005;143464;22792;86
United_Kingdom;UK;66647112;2020-04-26;4913;843;148377;23635;87
United_Kingdom;UK;66647112;2020-04-27;4463;420;152840;24055;88
United_Kingdom;UK;66647112;2020-04-28;4309;338;157149;24393;89
United_Kingdom;UK;66647112;2020-04-29;3996;909;161145;25302;90
United_Kingdom;UK;66647112;2020-04-30;4076;795;165221;26097;91
United_Kingdom;UK;66647112;2020-05-01;6032;674;171253;26771;92
United_Kingdom;UK;66647112;2020-05-02;6201;739;177454;27510;93
United_Kingdom;UK;66647112;2020-05-03;4806;621;182260;28131;94
United_Kingdom;UK;66647112;2020-05-04;4339;315;186599;28446;95
United_Kingdom;UK;66647112;2020-05-05;3985;288;190584;28734;96
United_Kingdom;UK;66647112;2020-05-06;4406;693;194990;29427;97
United_Kingdom;UK;66647112;2020-05-07;6211;649;201201;30076;98
United_Kingdom;UK;66647112;2020-05-08;5514;539;206715;30615;99
United_Kingdom;UK;66647112;2020-05-09;4649;626;211364;31241;100
United_Kingdom;UK;66647112;2020-05-10;3896;346;215260;31587;101
United_Kingdom;UK;66647112;2020-05-11;3923;268;219183;31855;102
United_Kingdom;UK;66647112;2020-05-12;3877;210;223060;32065;103
United_Kingdom;UK;66647112;2020-05-13;3403;627;226463;32692;104
United_Kingdom;UK;66647112;2020-05-14;3242;494;229705;33186;105
United_Kingdom;UK;66647112;2020-05-15;3446;428;233151;33614;106
United_Kingdom;UK;66647112;2020-05-16;3560;384;236711;33998;107
United_Kingdom;UK;66647112;2020-05-17;3450;468;240161;34466;108
United_Kingdom;UK;66647112;2020-05-18;3534;170;243695;34636;109
United_Kingdom;UK;66647112;2020-05-19;2711;160;246406;34796;110
United_Kingdom;UK;66647112;2020-05-20;2412;545;248818;35341;111
United_Kingdom;UK;66647112;2020-05-21;-525;363;248293;35704;112
United_Kingdom;UK;66647112;2020-05-22;2615;338;250908;36042;113
United_Kingdom;UK;66647112;2020-05-23;3287;351;254195;36393;114
United_Kingdom;UK;66647112;2020-05-24;2959;282;257154;36675;115
United_Kingdom;UK;66647112;2020-05-25;2405;118;259559;36793;116
United_Kingdom;UK;66647112;2020-05-26;1625;121;261184;36914;117
United_Kingdom;UK;66647112;2020-05-27;4043;134;265227;37048;118
United_Kingdom;UK;66647112;2020-05-28;2013;412;267240;37460;119
United_Kingdom;UK;66647112;2020-05-29;1887;377;269127;37837;120
United_Kingdom;UK;66647112;2020-05-30;2095;324;271222;38161;121
United_Kingdom;UK;66647112;2020-05-31;1604;215;272826;38376;122
United_Kingdom;UK;66647112;2020-06-01;1936;113;274762;38489;123
United_Kingdom;UK;66647112;2020-06-02;1570;556;276332;39045;124
United_Kingdom;UK;66647112;2020-06-03;1653;324;277985;39369;125
United_Kingdom;UK;66647112;2020-06-04;1871;359;279856;39728;126
United_Kingdom;UK;66647112;2020-06-05;1805;176;281661;39904;127
United_Kingdom;UK;66647112;2020-06-06;1650;357;283311;40261;128
United_Kingdom;UK;66647112;2020-06-07;1557;204;284868;40465;129
United_Kingdom;UK;66647112;2020-06-08;1326;77;286194;40542;130
United_Kingdom;UK;66647112;2020-06-09;1205;55;287399;40597;131
United_Kingdom;UK;66647112;2020-06-10;1741;286;289140;40883;132
United_Kingdom;UK;66647112;2020-06-11;1003;245;290143;41128;133
United_Kingdom;UK;66647112;2020-06-12;1266;151;291409;41279;134
United_Kingdom;UK;66647112;2020-06-13;1541;202;292950;41481;135
United_Kingdom;UK;66647112;2020-06-14;1425;181;294375;41662;136
United_Kingdom;UK;66647112;2020-06-15;1514;36;295889;41698;137
United_Kingdom;UK;66647112;2020-06-16;968;38;296857;41736;138
United_Kingdom;UK;66647112;2020-06-17;1279;233;298136;41969;139
United_Kingdom;UK;66647112;2020-06-18;1115;184;299251;42153;140
United_Kingdom;UK;66647112;2020-06-19;1218;135;300469;42288;141
United_Kingdom;UK;66647112;2020-06-20;1346;173;301815;42461;142
United_Kingdom;UK;66647112;2020-06-21;1295;128;303110;42589;143
United_Kingdom;UK;66647112;2020-06-22;1221;43;304331;42632;144
United_Kingdom;UK;66647112;2020-06-23;958;15;305289;42647;145
United_Kingdom;UK;66647112;2020-06-24;921;280;306210;42927;146
United_Kingdom;UK;66647112;2020-06-25;652;154;306862;43081;147
United_Kingdom;UK;66647112;2020-06-26;1118;149;307980;43230;148
United_Kingdom;UK;66647112;2020-06-27;1380;184;309360;43414;149
United_Kingdom;UK;66647112;2020-06-28;890;100;310250;43514;150
United_Kingdom;UK;66647112;2020-06-29;901;36;311151;43550;151
United_Kingdom;UK;66647112;2020-06-30;814;25;311965;43575;152
United_Kingdom;UK;66647112;2020-07-01;689;155;312654;43730;153
United_Kingdom;UK;66647112;2020-07-02;829;176;313483;43906;154
United_Kingdom;UK;66647112;2020-07-03;-29726;89;283757;43995;155
United_Kingdom;UK;66647112;2020-07-04;519;136;284276;44131;156
United_Kingdom;UK;66647112;2020-07-05;624;67;284900;44198;157
United_Kingdom;UK;66647112;2020-07-06;516;22;285416;44220;158
United_Kingdom;UK;66647112;2020-07-07;352;16;285768;44236;159
United_Kingdom;UK;66647112;2020-07-08;581;155;286349;44391;160
United_Kingdom;UK;66647112;2020-07-09;630;126;286979;44517;161
United_Kingdom;UK;66647112;2020-07-10;642;85;287621;44602;162
United_Kingdom;UK;66647112;2020-07-11;512;48;288133;44650;163
United_Kingdom;UK;66647112;2020-07-12;820;148;288953;44798;164
United_Kingdom;UK;66647112;2020-07-13;650;21;289603;44819;165
United_Kingdom;UK;66647112;2020-07-14;530;11;290133;44830;166
United_Kingdom;UK;66647112;2020-07-15;1240;138;291373;44968;167
United_Kingdom;UK;66647112;2020-07-16;538;85;291911;45053;168
United_Kingdom;UK;66647112;2020-07-17;641;66;292552;45119;169
United_Kingdom;UK;66647112;2020-07-18;687;114;293239;45233;170
United_Kingdom;UK;66647112;2020-07-19;827;40;294066;45273;171
United_Kingdom;UK;66647112;2020-07-20;726;27;294792;45300;172
United_Kingdom;UK;66647112;2020-07-21;580;12;295372;45312;173
United_Kingdom;UK;66647112;2020-07-22;445;110;295817;45422;174
United_Kingdom;UK;66647112;2020-07-23;560;79;296377;45501;175
United_States_of_America;US;329064917;2020-01-21;1;0;1;0;1
United_States_of_America;US;329064917;2020-01-22;0;0;1;0;2
United_States_of_America;US;329064917;2020-01-23;0;0;1;0;3
United_States_of_America;US;329064917;2020-01-24;0;0;1;0;4
United_States_of_America;US;329064917;2020-01-25;1;0;2;0;5
United_States_of_America;US;329064917;2020-01-26;0;0;2;0;6
United_States_of_America;US;329064917;2020-01-27;3;0;5;0;7
United_States_of_America;US;329064917;2020-01-28;0;0;5;0;8
United_States_of_America;US;329064917;2020-01-29;0;0;5;0;9
United_States_of_America;US;329064917;2020-01-30;0;0;5;0;10
United_States_of_America;US;329064917;2020-01-31;1;0;6;0;11
United_States_of_America;US;329064917;2020-02-01;1;0;7;0;12
United_States_of_America;US;329064917;2020-02-02;1;0;8;0;13
United_States_of_America;US;329064917;2020-02-03;3;0;11;0;14
United_States_of_America;US;329064917;2020-02-04;0;0;11;0;15
United_States_of_America;US;329064917;2020-02-05;0;0;11;0;16
United_States_of_America;US;329064917;2020-02-06;1;0;12;0;17
United_States_of_America;US;329064917;2020-02-07;0;0;12;0;18
United_States_of_America;US;329064917;2020-02-08;0;0;12;0;19
United_States_of_America;US;329064917;2020-02-09;0;0;12;0;20
United_States_of_America;US;329064917;2020-02-10;0;0;12;0;21
United_States_of_America;US;329064917;2020-02-11;1;0;13;0;22
United_States_of_America;US;329064917;2020-02-12;0;0;13;0;23
United_States_of_America;US;329064917;2020-02-13;1;0;14;0;24
United_States_of_America;US;329064917;2020-02-14;1;0;15;0;25
United_States_of_America;US;329064917;2020-02-15;0;0;15;0;26
United_States_of_America;US;329064917;2020-02-16;0;0;15;0;27
United_States_of_America;US;329064917;2020-02-17;0;0;15;0;28
United_States_of_America;US;329064917;2020-02-18;0;0;15;0;29
United_States_of_America;US;329064917;2020-02-19;0;0;15;0;30
United_States_of_America;US;329064917;2020-02-20;0;0;15;0;31
United_States_of_America;US;329064917;2020-02-21;1;0;16;0;32
United_States_of_America;US;329064917;2020-02-22;19;0;35;0;33
United_States_of_America;US;329064917;2020-02-23;0;0;35;0;34
United_States_of_America;US;329064917;2020-02-24;0;0;35;0;35
United_States_of_America;US;329064917;2020-02-25;18;0;53;0;36
United_States_of_America;US;329064917;2020-02-26;0;0;53;0;37
United_States_of_America;US;329064917;2020-02-27;6;0;59;0;38
United_States_of_America;US;329064917;2020-02-28;1;0;60;0;39
United_States_of_America;US;329064917;2020-02-29;6;0;66;0;40
United_States_of_America;US;329064917;2020-03-01;3;1;69;1;41
United_States_of_America;US;329064917;2020-03-02;20;1;89;2;42
United_States_of_America;US;329064917;2020-03-03;14;4;103;6;43
United_States_of_America;US;329064917;2020-03-04;22;3;125;9;44
United_States_of_America;US;329064917;2020-03-05;34;2;159;11;45
United_States_of_America;US;329064917;2020-03-06;74;1;233;12;46
United_States_of_America;US;329064917;2020-03-07;105;2;338;14;47
United_States_of_America;US;329064917;2020-03-08;95;3;433;17;48
United_States_of_America;US;329064917;2020-03-09;121;4;554;21;49
United_States_of_America;US;329064917;2020-03-10;200;5;754;26;50
United_States_of_America;US;329064917;2020-03-11;271;2;1025;28;51
United_States_of_America;US;329064917;2020-03-12;287;2;1312;30;52
United_States_of_America;US;329064917;2020-03-13;351;10;1663;40;53
United_States_of_America;US;329064917;2020-03-14;511;7;2174;47;54
United_States_of_America;US;329064917;2020-03-15;777;10;2951;57;55
United_States_of_America;US;329064917;2020-03-16;823;12;3774;69;56
United_States_of_America;US;329064917;2020-03-17;887;16;4661;85;57
United_States_of_America;US;329064917;2020-03-18;1766;23;6427;108;58
United_States_of_America;US;329064917;2020-03-19;2988;42;9415;150;59
United_States_of_America;US;329064917;2020-03-20;4835;0;14250;150;60
United_States_of_America;US;329064917;2020-03-21;5374;110;19624;260;61
United_States_of_America;US;329064917;2020-03-22;7123;80;26747;340;62
United_States_of_America;US;329064917;2020-03-23;8459;131;35206;471;63
United_States_of_America;US;329064917;2020-03-24;11236;119;46442;590;64
United_States_of_America;US;329064917;2020-03-25;8789;211;55231;801;65
United_States_of_America;US;329064917;2020-03-26;13963;249;69194;1050;66
United_States_of_America;US;329064917;2020-03-27;16797;246;85991;1296;67
United_States_of_America;US;329064917;2020-03-28;18695;411;104686;1707;68
United_States_of_America;US;329064917;2020-03-29;19979;484;124665;2191;69
United_States_of_America;US;329064917;2020-03-30;18360;318;143025;2509;70
United_States_of_America;US;329064917;2020-03-31;21595;661;164620;3170;71
United_States_of_America;US;329064917;2020-04-01;24998;909;189618;4079;72
United_States_of_America;US;329064917;2020-04-02;27103;1059;216721;5138;73
United_States_of_America;US;329064917;2020-04-03;28819;915;245540;6053;74
United_States_of_America;US;329064917;2020-04-04;32425;1104;277965;7157;75
United_States_of_America;US;329064917;2020-04-05;34272;1344;312237;8501;76
United_States_of_America;US;329064917;2020-04-06;25398;1146;337635;9647;77
United_States_of_America;US;329064917;2020-04-07;30561;1342;368196;10989;78
United_States_of_America;US;329064917;2020-04-08;30613;1906;398809;12895;79
United_States_of_America;US;329064917;2020-04-09;33323;1922;432132;14817;80
United_States_of_America;US;329064917;2020-04-10;33901;1873;466033;16690;81
United_States_of_America;US;329064917;2020-04-11;35527;2087;501560;18777;82
United_States_of_America;US;329064917;2020-04-12;28391;1831;529951;20608;83
United_States_of_America;US;329064917;2020-04-13;27620;1500;557571;22108;84
United_States_of_America;US;329064917;2020-04-14;25023;1541;582594;23649;85
United_States_of_America;US;329064917;2020-04-15;26922;2408;609516;26057;86
United_States_of_America;US;329064917;2020-04-16;30148;4928;639664;30985;87
United_States_of_America;US;329064917;2020-04-17;31667;2299;671331;33284;88
United_States_of_America;US;329064917;2020-04-18;30833;3770;702164;37054;89
United_States_of_America;US;329064917;2020-04-19;32922;1856;735086;38910;90
United_States_of_America;US;329064917;2020-04-20;24601;1772;759687;40682;91
United_States_of_America;US;329064917;2020-04-21;28065;1857;787752;42539;92
United_States_of_America;US;329064917;2020-04-22;37289;2524;825041;45063;93
United_States_of_America;US;329064917;2020-04-23;17588;1721;842629;46784;94
United_States_of_America;US;329064917;2020-04-24;26543;3179;869172;49963;95
United_States_of_America;US;329064917;2020-04-25;21352;1054;890524;51017;96
United_States_of_America;US;329064917;2020-04-26;48529;2172;939053;53189;97
United_States_of_America;US;329064917;2020-04-27;26857;1687;965910;54876;98
United_States_of_America;US;329064917;2020-04-28;22541;1369;988451;56245;99
United_States_of_America;US;329064917;2020-04-29;24132;2110;1012583;58355;100
United_States_of_America;US;329064917;2020-04-30;27326;2611;1039909;60966;101
United_States_of_America;US;329064917;2020-05-01;29917;2040;1069826;63006;102
United_States_of_America;US;329064917;2020-05-02;33955;2062;1103781;65068;103
United_States_of_America;US;329064917;2020-05-03;29288;1317;1133069;66385;104
United_States_of_America;US;329064917;2020-05-04;24972;1297;1158041;67682;105
United_States_of_America;US;329064917;2020-05-05;22593;1252;1180634;68934;106
United_States_of_America;US;329064917;2020-05-06;23841;2144;1204475;71078;107
United_States_of_America;US;329064917;2020-05-07;24128;2353;1228603;73431;108
United_States_of_America;US;329064917;2020-05-08;28369;2239;1256972;75670;109
United_States_of_America;US;329064917;2020-05-09;26957;1510;1283929;77180;110
United_States_of_America;US;329064917;2020-05-10;25612;1614;1309541;78794;111
United_States_of_America;US;329064917;2020-05-11;20258;734;1329799;79528;112
United_States_of_America;US;329064917;2020-05-12;18117;1156;1347916;80684;113
United_States_of_America;US;329064917;2020-05-13;22048;1703;1369964;82387;114
United_States_of_America;US;329064917;2020-05-14;20782;1746;1390746;84133;115
United_States_of_America;US;329064917;2020-05-15;27143;1773;1417889;85906;116
United_States_of_America;US;329064917;2020-05-16;25508;1662;1443397;87568;117
United_States_of_America;US;329064917;2020-05-17;24487;1186;1467884;88754;118
United_States_of_America;US;329064917;2020-05-18;18873;808;1486757;89562;119
United_States_of_America;US;329064917;2020-05-19;21841;791;1508598;90353;120
United_States_of_America;US;329064917;2020-05-20;19970;1568;1528568;91921;121
United_States_of_America;US;329064917;2020-05-21;23285;1518;1551853;93439;122
United_States_of_America;US;329064917;2020-05-22;25434;1263;1577287;94702;123
United_States_of_America;US;329064917;2020-05-23;24147;1305;1601434;96007;124
United_States_of_America;US;329064917;2020-05-24;21236;1080;1622670;97087;125
United_States_of_America;US;329064917;2020-05-25;20568;633;1643238;97720;126
United_States_of_America;US;329064917;2020-05-26;19064;500;1662302;98220;127
United_States_of_America;US;329064917;2020-05-27;18910;696;1681212;98916;128
United_States_of_America;US;329064917;2020-05-28;18721;1526;1699933;100442;129
United_States_of_America;US;329064917;2020-05-29;21817;1175;1721750;101617;130
United_States_of_America;US;329064917;2020-05-30;25337;1219;1747087;102836;131
United_States_of_America;US;329064917;2020-05-31;23297;945;1770384;103781;132
United_States_of_America;US;329064917;2020-06-01;19807;602;1790191;104383;133
United_States_of_America;US;329064917;2020-06-02;21086;764;1811277;105147;134
United_States_of_America;US;329064917;2020-06-03;20544;1034;1831821;106181;135
United_States_of_America;US;329064917;2020-06-04;19699;994;1851520;107175;136
United_States_of_America;US;329064917;2020-06-05;21140;1036;1872660;108211;137
United_States_of_America;US;329064917;2020-06-06;25178;932;1897838;109143;138
United_States_of_America;US;329064917;2020-06-07;22223;659;1920061;109802;139
United_States_of_America;US;329064917;2020-06-08;22302;712;1942363;110514;140
United_States_of_America;US;329064917;2020-06-09;18822;493;1961185;111007;141
United_States_of_America;US;329064917;2020-06-10;18665;999;1979850;112006;142
United_States_of_America;US;329064917;2020-06-11;20614;918;2000464;112924;143
United_States_of_America;US;329064917;2020-06-12;22883;896;2023347;113820;144
United_States_of_America;US;329064917;2020-06-13;25639;849;2048986;114669;145
United_States_of_America;US;329064917;2020-06-14;25540;767;2074526;115436;146
United_States_of_America;US;329064917;2020-06-15;19543;296;2094069;115732;147
United_States_of_America;US;329064917;2020-06-16;19957;395;2114026;116127;148
United_States_of_America;US;329064917;2020-06-17;23705;836;2137731;116963;149
United_States_of_America;US;329064917;2020-06-18;25559;754;2163290;117717;150
United_States_of_America;US;329064917;2020-06-19;27762;717;2191052;118434;151
United_States_of_America;US;329064917;2020-06-20;29909;678;2220961;119112;152
United_States_of_America;US;329064917;2020-06-21;34158;607;2255119;119719;153
United_States_of_America;US;329064917;2020-06-22;25793;256;2280912;119975;154
United_States_of_America;US;329064917;2020-06-23;31390;427;2312302;120402;155
United_States_of_America;US;329064917;2020-06-24;34720;826;2347022;121228;156
United_States_of_America;US;329064917;2020-06-25;34339;751;2381361;121979;157
United_States_of_America;US;329064917;2020-06-26;40949;2437;2422310;124416;158
United_States_of_America;US;329064917;2020-06-27;45527;623;2467837;125039;159
United_States_of_America;US;329064917;2020-06-28;42486;500;2510323;125539;160
United_States_of_America;US;329064917;2020-06-29;38673;265;2548996;125804;161
United_States_of_America;US;329064917;2020-06-30;41556;336;2590552;126140;162
United_States_of_America;US;329064917;2020-07-01;43880;1270;2634432;127410;163
United_States_of_America;US;329064917;2020-07-02;52048;652;2686480;128062;164
United_States_of_America;US;329064917;2020-07-03;53399;678;2739879;128740;165
United_States_of_America;US;329064917;2020-07-04;54442;694;2794321;129434;166
United_States_of_America;US;329064917;2020-07-05;45221;242;2839542;129676;167
United_States_of_America;US;329064917;2020-07-06;49093;271;2888635;129947;168
United_States_of_America;US;329064917;2020-07-07;49990;359;2938625;130306;169
United_States_of_America;US;329064917;2020-07-08;57473;1174;2996098;131480;170
United_States_of_America;US;329064917;2020-07-09;58906;829;3055004;132309;171
United_States_of_America;US;329064917;2020-07-10;63004;982;3118008;133291;172
United_States_of_America;US;329064917;2020-07-11;66625;806;3184633;134097;173
United_States_of_America;US;329064917;2020-07-12;63051;717;3247684;134814;174
United_States_of_America;US;329064917;2020-07-13;57258;391;3304942;135205;175
United_States_of_America;US;329064917;2020-07-14;58114;400;3363056;135605;176
United_States_of_America;US;329064917;2020-07-15;68518;861;3431574;136466;177
United_States_of_America;US;329064917;2020-07-16;67717;953;3499291;137419;178
United_States_of_America;US;329064917;2020-07-17;76930;939;3576221;138358;179
United_States_of_America;US;329064917;2020-07-18;71494;908;3647715;139266;180
United_States_of_America;US;329064917;2020-07-19;63749;853;3711464;140119;181
United_States_of_America;US;329064917;2020-07-20;61796;415;3773260;140534;182
United_States_of_America;US;329064917;2020-07-21;56750;372;3830010;140906;183
United_States_of_America;US;329064917;2020-07-22;72048;1160;3902058;142066;184
United_States_of_America;US;329064917;2020-07-23;68848;1124;3970906;143190;185
